##############
##############
##############
##############
####+---+#####
####|...|#####
####|...|#####
####|...|#####
####+---+#####
##############
##############
##############
##############
##############
##############
##############
